F  80,0,80
C 0,0,139


SO textures/flower.xpm
NO textures/cacti.xpm
WE textures/palm.xpm
EA textures/vines.xpm

11111111111111111111
10000000000000000001
11110111111111111101
10000100000100000001
10110101111111110101
12110000000000010101
11111110111111110111
10000000100000000001
10111111111111111101
10000000000000000001
111111111N1111111111
11111111111111111111