F  80,0,80
C 0,0,139


SO textures/shark.xpm
NO textures/octo.xpm
WE textures/duck.xpm
EA textures/duck.xpm

11111111111111111111
10000000000000000001
10111111111111111101
10000000000000000101
10110111111111110101
10110100000000000101
11111111111111110101
10000000000000000121
10111111111111111111
100000000000000000W1
11111111111111111111